8 10 
0 0 0 8 0 0 0 0 0 0
0 0 0 8 0 0 0 0 0 0
0 0 0 8 0 0 0 0 0 0
0 0 0 8 0 0 0 0 0 0
0 0 0 8 8 8 8 0 0 0
0 0 0 0 0 0 0 0 0 0
0 0 0 0 0 0 0 0 0 0
0 0 0 0 0 0 0 0 0 0
2
2 2
3 3
1 3
6
1 1 5 0
0 4 2 90
2 5 7 0
8 6 20 180
8 2 6 90
4 2 3 270
1 1
2
4
1 6 10 0
7 6 13 0
7 2 19 0
4 0 1 0
3
0 0
4 7
4 3